201,0,2,2,0,0,0,0,0,0,0,0,3,3,3,3
0,0,2,2,0,0,0,0,0,0,0,0,0,0,0,0
0,0,0,0,0,0,0,0,0,0,0,0,0,0,0,0
1,1,1,1,0,0,0,0,0,0,0,1,0,0,1,0
0,0,0,0,0,0,0,0,0,0,0,0,1,1,0,0
0,3,3,3,0,0,0,0,0,0,0,0,0,0,0,0
0,3,3,3,0,0,0,0,4,4,0,0,0,0,0,0
0,3,3,3,0,0,0,0,4,4,0,0,0,0,0,0
0,0,0,0,0,0,0,0,4,4,0,0,0,0,0,0
0,0,0,0,0,0,2,2,0,0,2,2,0,0,0,0
0,0,0,4,0,0,2,2,0,0,2,2,0,0,0,0
0,0,0,0,0,0,2,2,0,0,0,0,0,0,0,175
0,0,0,0,0,0,0,0,0,0,0,0,0,0,0,238
3,3,0,0,0,0,0,0,0,0,0,0,0,0,0,239
3,3,0,1,0,0,0,67,82,128,0,0,0,0,0,4
